+-----------------+-------------------+
|                 |                   |
|                 |                   |
|                 |                   |
|     (sample)    |      (sample2)    |
|                 |                   |
|                 |                   |
+-----------------+                   |
|                 |                   |
|    (room3)      |                   |
|                 |                   |
+-----------------+-------------------+